青云镇|Greenhaven
石峰岭|Stonepeak
红霞谷|Redvale
银月湾|Silvermoon
金风林|Goldenwind
白水溪|Whitebrook
风雷山|Stormridge
月影湖|Moonglade
花海城|Blossomtown
水镜村|Mirrorford
星辰岭|Starlight
山川原|Mountvale
云雾谷|Cloudveil
雷霆堡|Thunderhold
电光溪|Lightningbrook
秋霜岭|Autumnridge
冬雪林|Winterwood
寒冰湖|Frostlake
暖阳村|Sunford
火焰峰|Flamepeak
木影岭|Shadowwood
沙漠湾|Sandsbay
天穹镇|Skyhaven
阳光村|Sunshineford
翠竹谷|Emeraldvale
龙焰堡|Dragonhold
凤翎城|Phoenixspire
湖心镇|Lakehaven
玉泉原|Jadehaven
幽兰溪|Mysticbrook
清风岭|Breezeridge
流沙谷|Shiftingvale
雪影山|Snowpeak
烟岚林|Fogwood
碧溪村|Crystalbrook
丹霞镇|Scarletford
瑶光原|Auroravale
玄月城|Obsidianmoon
天镜湖|Mirrorlake
灵风堡|Spiritward
碧落岭|Emeraldridge
孤帆湾|Driftbay
青霭谷|Azurevale
苍穹峰|Etherealpeak
琼光村|Luminousford
烟波镇|Mistvalley
落日林|Duskgrove
沧海城|Deepseahaven
墨香溪|Inkbrook
晴岚原|Brightvale
风云镇|Stormhaven
赤焰堡|Fireward
雷鸣谷|Thunderveil
落星湾|Fallingstarbay
银霜岭|Silversnowridge
翠羽林|Plumefeatherwood
星辉镇|Starglowford
玉珑山|Jadeshellpeak
碧霞溪|Skyblushbrook
龙吟谷|Dragonsongvale
凤舞岭|Phoenixdanceridge
天风城|Skybreezehaven
幻影原|Phantomvale
火莲镇|Flamelotusford
金辉湾|Goldenlightbay
银夜村|Silvernightwood
冷月岭|Coldmoonridge
孤星峰|Solitarystarpeak
蓝玉城|Sapphirehaven
碧水溪|Aquabrook
琉璃谷|Glassvale
翠湖镇|Greendewhaven
琥珀林|Amberwood
冰晶原|Frostcrystalvale
紫霞岭|Amethystridge
云雾村|Cloudmistford
晴川镇|Sunshinevalley
孤影堡|Shadowward
灵狐岭|Spiritfoxridge
墨莲溪|Inklotusbrook
寒星湾|Icybay
流光城|Luminashore
焰阳谷|Brightsunvale
星尘镇|Starhaven
影风岭|Shadowbreezeridge
天歌原|Skylyricvale
碧月城|Emeraldmoonhaven
水晶谷|Crystalvale
夜影林|Nightshadewood
星河镇|Galaxyford
凤影湾|Phoenixshadeward
寒梅岭|Wintersweetpeak
烈焰峰|Infernopeak
风暴堡|Stormhold
空灵林|Hollowwood
暮光溪|Twilightbrook
晴雪原|Snowyvale
苍星城|Etherealstarhaven
紫霜镇|Amethystsnowford
夜月岭|Nocturneridge
银辉湾|Silverlightbay
冰雪谷|Frostvalley
烈阳镇|Blazingsunford
晨曦原|Morningvale
光辉林|Radiantwood
夜幕城|Nightfallhaven
寒冰谷|Glaciervale
天影岭|Skyshadowridge
流星湾|Shootingstarbay
碧空镇|Azurehaven
冷霜原|Chillvale
星光谷|Starshinevalley
玉龙城|Jadedragonhaven
琼瑶溪|Jadelustrebrook
金莲镇|Goldenlotusford
蓝影林|Sapphirewood
紫星谷|Violetstarvale
烈火岭|Burningridge
飞雪城|Snowfallhaven
暮星镇|Eveningstarford
灵魂谷|Spiritvale
白霜岭|Whitesnowridge
晴星湾|Sunstarbay
玄霜镇|Mystsnowford
耀阳原|Shiningvale
孤月岭|Lunarridge
光辉谷|Radiancevale
夜辉镇|Nightglowford
沧星城|Bluestarhaven
寒雾岭|Frostfogridge
暮月湾|Dusklunarbord
焰火原|Flamevale
流雪镇|Flowingsnowford
镜湖城|Mirrorshore
烈霜岭|Frozenflameridge
风影谷|Windshadowvale
龙月镇|Dragonmoonford
玄火岭|Mysticflameridge
寒星溪|Frozenstarbrook
月光镇|Moonshineford
星辉城|Starlighthaven
